1111111111111
10010000000C1
1111111111111
1P1111E000001
1111111111111
