11111HOLA1111
10010000000C1
100001111100A
1P0011E000001
111111BB11111
