1111111111111
10010000000E1
1000011111101
1P0011C000001
1111111111111
